BBBBBBBBBBBB
B..........B
B..........B
B.......BEEB
B.......BBBB
B.......BBBB
B.....BBBBBB
B.P...BBBBBB
B...BBBBBBBB
BBBBBBBBBBBB