BBBBBBBBBBBBBBBBBBBB
B.P.....K.........SB
B........K........SB
B...KK......KK....SB
BBBBSSBBBBBBBKK...SB
B............SK...SB
B............SK...SB
B.................SB
B......K..........SB
B.....KKK.........SB
BE...KKKKK........SB
BBBBBBBBBBSSSBBBBBBB