BBBBBBBBBBBBB
B.......BEEEB
B.......B...B
B...B...B...B
B...B...B...B
B...B...B...B
B.P.B.......B
B...B.......B
BBBBBBBBBBBBB