..E................S
...................S
....................
B...BBB.......KK....
.........B..........
......KK............
............BB......
BB...............BSB
........KK..........
....................
.KK.........BBB.....
.....S..............
.................BB.
BB......BBB.........
..............B.....
....BB..............
....................
..........BBB....P..
..BBB...............
.......SS......SBBB.