BBBBBBBBBBBBBBBBBBBBBBBBBBBBB
B..............B
B..............B
B..............B
B..............B
B..............B
B..............B
B..............B
B..............B
B..............B
B..............B
B..............B
B..............B
B.P............B
B..............B
BBBBBBBBBBBBBBBB
B
B
B
B
B
B
B
B