BBBBBBBBBBBBBBBBB
B....B.....B....B
B....B.....B....B
B.......B.......B
B.......B.......B
B.......B.......B
B.......B.......B
B...B.......B...B
B...B.......B...B
B.P.............B
B..............EB
BBBBKKKKKKKKKBBBB