BBBBBBBBBBBBBBBB
B..............B
B..............B
B..............B
B..............B
B..............B
B..............B
B..............B
B..............B
B..............B
B..............B
B..............B
B..............B
B.P............B
B...........BEEB
BBBBBB.....BBBBB